phone_name,Brand,ratting_out_of_five,Rated_people,Offered_price_in_rupee,real_rice_in_rupee,Total,Percent_off
"Samsung Galaxy S20 FE 5G (Cloud Navy, 8GB RAM, 128GB Storage) with No Cost EMI & Additional Exchange Offers",Samsung,4.4,"17,194",39990,74999,114989,47
"Samsung Galaxy M32 (Light Blue, 4GB RAM, 64GB | FHD+ sAMOLED 90Hz Display | 6000mAh Battery | 64MP Quad Camera",Samsung,4.1,"44,417",14999,16999,31998,12
"Redmi 9A Sport (Coral Green, 2GB RAM, 32GB Storage) | 2GHz Octa-core Helio G25 Processor | 5000 mAh Battery",Redmi,4.2,"1,78,833",6999,8499,15498,18
"I KALL Z4 Smartphone (5.5 Inch Display, 4GB, 32GB) (Android 8.1) (Grey)",I Kall,,,4999,6499,11498,23
"Redmi 9A Sport (Carbon Black, 2GB RAM, 32GB Storage) | 2GHz Octa-core Helio G25 Processor | 5000 mAh Battery",Redmi,4.2,"1,78,833",6999,7999,14998,13
"Jio Next 32 GB ROM, 2 GB RAM, Blue Smartphone",Jio,3.6,"1,071",4500,7299,11799,38
"Redmi Note 10 Pro (Vintage Bronze, 6GB RAM, 128GB Storage) -120Hz Super Amoled Display | 64MP Camera with 5MP Super Tele-Macro | 33W Charger Included",Redmi,4.2,"67,933",15999,19999,35998,20
Redmi 10 Prime (Phantom Black 4GB RAM 64GB | Helio G88 with extendable RAM Upto 2GB | FHD+ 90Hz Adaptive Sync Display),Redmi,4.1,"46,562",11499,14999,26498,23
"Redmi Note 11 (Space Black, 4GB RAM, 64GB Storage)|90Hz FHD+ AMOLED Display | Qualcomm® Snapdragon™ 680-6nm | Alexa Built-in | 33W Charger Included | Get 2 Months of YouTube Premium Free!",Redmi,4.1,"29,838",12999,17999,30998,28
"realme narzo 50i (Mint Green, 2GB RAM+32GB Storage) - 6.5"" inch Large Display | 5000mAh Battery",realme,4,"19,708",7499,7999,15498,6
"Samsung Galaxy M33 5G (Emerald Brown, 6GB, 128GB Storage) | 6000mAh Battery | Upto 12GB RAM with RAM Plus | Travel Adapter to be Purchased Separately",Samsung,4,"8,508",17999,24999,42998,28
"Samsung Galaxy M53 5G (Emerald Brown, 6GB, 128GB Storage) | 108MP | sAmoled+ 120Hz | 12GB RAM with RAM Plus | Travel Adapter to be Purchased Separately",Samsung,3.8,"2,741",26499,32999,59498,20
"Redmi Note 11 (Horizon Blue, 6GB RAM, 128GB Storage)|90Hz FHD+ AMOLED Display | Qualcomm® Snapdragon™ 680-6nm | Alexa Built-in | 33W Charger Included | Get 2 Months of YouTube Premium Free!",Redmi,4.1,"29,838",15999,19999,35998,20
"OPPO A74 5G (Fluid Black, 6GB RAM, 128GB Storage) with No Cost EMI/Additional Exchange Offers",OPPO,4.2,"26,496",14990,20990,35980,29
"Nokia G21 Android Smartphone, Dual SIM, 3-Day Battery Life, 6GB RAM + 128GB Storage, 50MP Triple AI Camera | Nordic Blue",Nokia,4.1,832,14999,16999,31998,12
"Redmi 10A (Slate Grey, 4GB RAM, 64GB Storage)",Redmi,3.6,493,8999,11999,20998,25
"Jio Jio Phone Next 32 GB ROM, 2 GB RAM, Blue, Smartphone",Jio,3.6,153,4465,7499,11964,40
"iQOO vivo Z6 44W (Lumina Blue, 6GB RAM, 128GB Storage) | 44W FlashCharge + 5000mAh Battery | FHD+ AMOLED Display | in-Display Fingerprint",iQOO,4.1,"5,357",15999,20999,36998,24
"Redmi 9 Activ (Carbon Black, 4GB RAM, 64GB Storage)",Redmi,4.2,"1,69,715",9499,10999,20498,14
"Tecno POVA 3 (Eco Black, 6GB RAM, 128GB Storage)| 7000mAh Battery |33W Fast Charger | 6.9"" FHD+ Display | 90 Hz Refresh Rate | 50MP Triple Camera | Helio G88 Gaming Processor",Tecno,4,256,13299,14999,28298,11
"Tecno Camon 19 Neo (Ice Mirror, 6GB RAM, 128GB Storage)|48MP Super Night Rear Camera|32MP Selfie Camera|Upto 11GB Expandable RAM|6.8"" FHD+LTPS Display|Helio G85 Processor",Tecno,3.3,5,14999,18499,33498,19
"Tecno Spark 9 (Infinity Black, 6GB RAM, 128GB Storage)| Upto 11GB Expandable RAM | 90Hz Refresh Rate | 6.6"" HD+Display | 13MP Dual Camera | 5000mAh Battery | Helio G37 Gaming Processor",Tecno,4.2,27,9999,13499,23498,26
"Samsung Galaxy S20 FE 5G (Cloud Mint, 8GB RAM, 128GB Storage)",Samsung,4.4,"17,194",39990,74990,114980,47
"Samsung Galaxy M32 (Light Blue, 6GB RAM, 128GB | FHD+ sAMOLED 90Hz Display | 6000mAh Battery | 64MP Quad Camera",Samsung,4.1,"44,417",16999,18999,35998,11
"I KALL Z9 Smartphone (6 Inch, 3GB, 32GB) (Blue)",I Kall,5,2,5499,6999,12498,21
"realme narzo 50i (Mint Green, 4GB RAM+64GB Storage) - 6.5"" inch Large Display | 5000mAh Battery",realme,4,"19,708",8999,9999,18998,10
"OPPO A15s (Dynamic Black, 4GB RAM, 64GB Storage) With No Cost EMI/Additional Exchange Offers",OPPO,4.3,"5,989",9990,13990,23980,29
"Redmi 9A Sport (Coral Green, 3GB RAM, 32GB Storage) | 2GHz Octa-core Helio G25 Processor | 5000 mAh Battery",Redmi,4.2,"1,78,833",7799,9499,17298,18
Redmi 9A(Midnight Black 3GB RAM 32GB Storage) | 2GHz Octa-core Helio G25 Processor | 5000 mAh Battery,Redmi,4.2,"1,78,833",7799,8299,16098,6
"Redmi 10A (Charcoal Black, 3GB RAM, 32GB Storage)",Redmi,3.8,249,8299,10999,19298,25
"realme narzo 50i (Carbon Black, 2GB RAM+32GB Storage) - 6.5"" inch Large Display | 5000mAh Battery",realme,4,"19,708",7499,7999,15498,6
"Redmi 9A Sport (Metallic Blue, 3GB RAM, 32GB Storage) | 2GHz Octa-core Helio G25 Processor | 5000 mAh Battery",Redmi,4.2,"1,78,833",7799,9499,17298,18
"Samsung Galaxy M13 (Stardust Brown, 6GB, 128GB Storage) | 6000mAh Battery | Upto 12GB RAM with RAM Plus",Samsung,4.1,"1,57,088",13999,17999,31998,22
"Samsung Galaxy M53 5G (Emerald Brown, 8GB, 128GB Storage) | 108MP | sAmoled+ 120Hz | 16GB RAM with RAM Plus | Travel Adapter to be Purchased Separately",Samsung,3.8,"2,741",28499,34999,63498,19
"Redmi 9 Activ (Coral Green, 4GB RAM, 64GB Storage)",Redmi,4.2,"1,69,715",9499,10999,20498,14
Redmi 10A Sport Slate Grey 6GB RAM 128GB ROM,Redmi,,,10999,13999,24998,21
"I KALL Z1 Smartphone (5.5 Inch, 4GB, 32GB, Dual Sim) (Grey)",I Kall,2.2,6,4999,6499,11498,23
Redmi 10A Sport Sea Blue 6GB RAM 128GB ROM,Redmi,,,10999,13999,24998,21
"Tecno Spark 9 (Sky Mirror, 4GB RAM, 64GB Storage)| Upto 7GB Expandable RAM | 90Hz Refresh Rate | 6.6"" HD+Display | 13MP Dual Camera | 5000mAh Battery | Helio G37 Gaming Processor",Tecno,4.2,27,8999,11499,20498,22
"Tecno Spark 9 (Sky Mirror, 6GB RAM, 128GB Storage)| Upto 11GB Expandable RAM | 90Hz Refresh Rate | 6.6"" HD+Display | 13MP Dual Camera | 5000mAh Battery | Helio G37 Gaming Processor",Tecno,4.2,27,9999,13499,23498,26
"Jio Phone Next 32 GB ROM, 2 GB RAM, Black Smartphone",Jio,3.7,88,4749,7299,12048,35
"SHIVANSH LYF C451 (, 8 GB) (1 GB RAM) Color ASSORTTED",SHIVANSH LYF,,,3350,8990,12340,63
"Tecno Spark 9 (Sky Mirror, 6GB RAM, 128GB Storage)| Upto 11GB Expandable RAM | 90Hz Refresh Rate | 6.6"" HD+Display | 13MP Dual Camera | 5000mAh Battery | Helio G37 Gaming Processor",Tecno,4.2,27,9999,13499,23498,26
"Samsung Galaxy M33 5G (Mystique Green, 6GB, 128GB Storage) | 6000mAh Battery | Upto 12GB RAM with RAM Plus | Travel Adapter to be Purchased Separately",Samsung,4,"8,508",17999,24999,42998,28
"Samsung Galaxy M13 (Aqua Green, 6GB, 128GB Storage) | 6000mAh Battery | Upto 12GB RAM with RAM Plus",Samsung,4.1,"1,57,088",13999,17999,31998,22
"Samsung Galaxy S20 FE 5G (Cloud Lavender, 8GB RAM, 128GB Storage) with No Cost EMI & Additional Exchange Offers",Samsung,4.4,"17,194",39990,74999,114989,47
"Samsung Galaxy M13 (Aqua Green, 4GB, 64GB Storage) | 6000mAh Battery | Upto 8GB RAM with RAM Plus",Samsung,4.1,"1,57,088",11999,14999,26998,20
"Nokia C01 Plus 4G, 5.45” HD+ Screen, Selfie Camera with Front Flash | 32GB Storage (Blue)",Nokia,3.6,"1,660",6299,7999,14298,21
"Samsung Galaxy M32 (Black, 4GB RAM, 64GB | FHD+ sAMOLED 90Hz Display | 6000mAh Battery | 64MP Quad Camera",Samsung,4.1,"44,417",14999,16999,31998,12
"Jio Next 32 GB, 2 GB RAM, Blue Smartphone",Jio,3.5,346,4499,5999,10498,25
"Redmi 10 (Caribbean Green, 4GB RAM, 64GB Storage)",Redmi,3.7,89,10690,14999,25689,29
"Redmi Note 10T 5G (Chromium White 4GB RAM, 64GB Storage) | Dual 5G | 90Hz Adaptive Refresh Rate | MediaTek Dimensity 700 7nm Processor | 22.5W Charger Included",Redmi,4.1,"2,342",11999,16999,28998,29
"Samsung Galaxy M52 5G (Blazing Black, 6GB RAM, 128GB Storage) Latest Snapdragon 778G 5G | sAMOLED 120Hz Display",Samsung,4.2,"15,376",24999,34999,59998,29
"Redmi 10A (Charcoal Black, 4GB RAM, 64GB Storage)",Redmi,3.6,554,8999,11999,20998,25
"Samsung Galaxy M32 (Black, 6GB RAM, 128GB | FHD+ sAMOLED 90Hz Display | 6000mAh Battery | 64MP Quad Camera",Samsung,4.1,"44,417",16999,18999,35998,11
"Vivo Y72 5G (Slate Gray, 8GB RAM, 128GB Storage) with No Cost EMI/Additional Exchange Offers",Vivo,4.1,"1,345",21989,24990,46979,12
"Redmi 9A Sport (Metallic Blue, 2GB RAM, 32GB Storage) | 2GHz Octa-core Helio G25 Processor | 5000 mAh Battery",Redmi,4.2,"1,78,833",6999,7999,14998,13
"I KALL Z5 Smartphone (3GB, 16GB) | Android 10.0 | 5.5 Inch Display (Pink)",I Kall,5,2,4699,5999,10698,22
"Nuveck KARBONN Aura Power 4G+ (Champagne, 8 GB)  (1 GB RAM)",Nuveck,,,3600,7999,11599,55
"realme narzo 50A (Oxygen Blue , 4GB RAM + 128 GB Storage) Helio G85 Processor | 6000 mAh Battery",realme,4.2,"33,514",12499,13999,26498,11
"Redmi Note 11 (Starburst White, 4GB RAM, 64GB Storage) | 90Hz FHD+ AMOLED Display | Qualcomm® Snapdragon™ 680-6nm | Alexa Built-in | 33W Charger Included | Get 2 Months of YouTube Premium Free!",Redmi,4.1,"29,838",12999,17999,30998,28
"OPPO A31 (Mystery Black, 6GB RAM, 128GB Storage) with No Cost EMI/Additional Exchange Offers",OPPO,4.2,"54,016",11990,15990,27980,25
"Lava Z21 (2GB RAM, 32GB ROM)-Cyan| Octa Core Processor| Stock Android 11| Powerful 3100 mAh Battery",Lava,3.4,229,5599,5999,11598,7
"Redmi Note 11 (Horizon Blue, 4GB RAM, 64GB Storage) | 90Hz FHD+ AMOLED Display | Qualcomm® Snapdragon™ 680-6nm | Alexa Built-in | 33W Charger Included | Get 2 Months of YouTube Premium Free!",Redmi,4.1,"29,838",12999,17999,30998,28
"Samsung Galaxy M53 5G (Mystique Green, 6GB, 128GB Storage) | 108MP | sAmoled+ 120Hz | 12GB RAM with RAM Plus | Travel Adapter to be Purchased Separately",Samsung,3.8,"2,741",26499,32999,59498,20
"Samsung Galaxy M33 5G (Mystique Green, 8GB, 128GB Storage) | 6000mAh Battery | Upto 16GB RAM with RAM Plus | Travel Adapter to be Purchased Separately",Samsung,4,"8,508",19499,25999,45498,25
"Samsung Galaxy M13 (Midnight Blue, 6GB, 128GB Storage) | 6000mAh Battery | Upto 12GB RAM with RAM Plus",Samsung,4.1,"1,57,088",13999,17999,31998,22
"Samsung Galaxy M32 (Black, 4GB RAM, 64GB | FHD+ sAMOLED 90Hz Display | 6000mAh Battery | 64MP Quad Camera",Samsung,4.1,"44,417",14999,16999,31998,12
"Redmi Note 11 (Horizon Blue, 4GB RAM, 64GB Storage) | 90Hz FHD+ AMOLED Display | Qualcomm® Snapdragon™ 680-6nm | Alexa Built-in | 33W Charger Included | Get 2 Months of YouTube Premium Free!",Redmi,4.1,"29,838",12999,17999,30998,28
"OnePlus Nord CE 2 5G (Bahamas Blue, 8GB RAM, 128GB Storage)",OnePlus,4.3,"36,852",24999,,,
"OPPO A15s (Rainbow Silver, 4GB RAM, 64GB Storage) With No Cost EMI/Additional Exchange Offers",OPPO,4.3,"5,989",9990,13990,23980,29
"Nokia 2.3 Android 10 Smartphone 2GB RAM, 32GB Storage, Dual Rear Camera, Charcoal",Nokia,3.6,"1,166",6999,10499,17498,33
"vivo iQOO Z6 44W (Raven Black, 8GB RAM, 128GB Storage) | 44W FlashCharge + 5000mAh Battery | FHD+ AMOLED Display | in-Display Fingerprint",vivo,4.1,"5,357",16999,20999,37998,19
"Lava X2 (2+32GB, Striped Cyan) | Fingerprint Sensor | Octa Core Mediatek Processor | 6.5"" HD+ Display | 8MP Dual AI Camera | 5000 mAh Battery | Type-C Charger",Lava,4.1,748,6999,7999,14998,13
"OnePlus Nord CE 2 Lite 5G (Black Dusk, 6GB RAM, 128GB Storage)",OnePlus,4.2,"14,513",,,,
"OnePlus Nord CE 2 Lite 5G (Blue Tide, 6GB RAM, 128GB Storage)",OnePlus,4.2,"14,513",19999,,,
"Samsung Galaxy M53 5G (Mystique Green, 8GB, 128GB Storage) | 108MP | sAmoled+ 120Hz | 16GB RAM with RAM Plus | Travel Adapter to be Purchased Separately",Samsung,3.8,"2,741",28499,34999,63498,19
"OPPO A15s (Dynamic Black, 4GB RAM, 64GB Storage) With No Cost EMI/Additional Exchange Offers",OPPO,4.3,"5,989",9990,13990,23980,29
"OPPO A74 5G (Fantastic Purple,6GB RAM,128GB Storage) with No Cost EMI/Additional Exchange Offers",OPPO,4.2,"26,496",14990,20990,35980,29
"Redmi 10A (Slate Grey, 3GB RAM, 32GB Storage)",Redmi,3.8,249,8299,10999,19298,25
"Redmi Note 10 Pro (Dark Night, 6GB RAM, 128GB Storage) -120hz Super Amoled Display|64MPwith 5mp Super Tele-Macro | 33W Charger Included",Redmi,4.2,"67,933",15999,19999,35998,20
"Nokia C01 Plus 4G, 5.45” HD+ Screen, Selfie Camera with Front Flash | 32GB Storage (Grey)",Nokia,3.6,"1,660",6790,7999,14789,15
"Redmi Note 10T 5G (Mint Green, 4GB RAM, 64GB Storage) | Dual5G | 90Hz Adaptive Refresh Rate | MediaTek Dimensity 700 7nm Processor | 22.5W Charger Included",Redmi,4.2,"1,21,362",11999,16999,28998,29
"Samsung Galaxy M13 (Midnight Blue, 4GB, 64GB Storage) | 6000mAh Battery | Upto 8GB RAM with RAM Plus",Samsung,4.1,"1,57,088",11999,14999,26998,20
"OnePlus Nord CE 2 5G (Gray Mirror, 8GB RAM, 128GB Storage)",OnePlus,4.3,"36,852",24999,,,
"Samsung Galaxy A13 Blue, 6GB RAM, 128GB Storage with No Cost EMI/Additional Exchange Offers, (SM-A135FLBJINS)",Samsung,3.9,265,16499,20990,37489,21
"Samsung Galaxy M33 5G (Deep Ocean Blue, 6GB, 128GB Storage) | 6000mAh Battery | Upto 12GB RAM with RAM Plus | Travel Adapter to be Purchased Separately",Samsung,4,"8,508",17999,24999,42998,28
"I KALL Z5 Smartphone (3GB, 16GB) | Android 10.0 | 5.5 Inch Display (Pink)",I Kall,5,2,4699,5999,10698,22
"Samsung Galaxy M13 (Aqua Green, 4GB, 64GB Storage) | 6000mAh Battery | Upto 8GB RAM with RAM Plus",Samsung,4.1,"1,57,088",11999,14999,26998,20
"Samsung Galaxy M53 5G (Deep Ocean Blue, 6GB, 128GB Storage) | 108MP | sAmoled+ 120Hz | 12GB RAM with RAM Plus | Travel Adapter to be Purchased Separately",Samsung,3.8,"2,741",26499,32999,59498,20
"Tecno Pop 5 LTE(Deepsea Luster 2G+32GB)| 6.52"" HD+Dot Notch | 5000mAh | 8MP Dual Camera | Front Flash| IPX2 Splash Resistant",Tecno,4.2,"3,705",6699,8999,15698,26
"Redmi Note 10 Pro Max (Vintage Bronze, 6GB RAM, 128GB Storage) -108MP Quad Camera | 120Hz Super Amoled Display",Redmi,4.1,"42,255",17999,22999,40998,22
"Nokia C01 Plus 4G, 5.45” HD+ Screen, Selfie Camera with Front Flash (Grey)",Nokia,3.6,"1,660",6225,7999,14224,22
"Redmi 9 Activ (Metallic Purple, 6GB RAM, 128GB Storage)",Redmi,4.2,"1,69,715",10999,12999,23998,15
itel A23 Pro_Open Version (5'' FWVGA Bright Display | 8GB+1GB Memory | Smart Face Unlock | 2400mAh Battery | 2MP Rear Camera | Selfie Camera)_Sapphire Blue,itel,3,328,4285,4999,9284,14
"I KALL Z5 Smartphone (3GB, 16GB) | Android 10.0 | 5.5 Inch Display (Green)",I Kall,5,2,4699,5999,10698,22
"Samsung Galaxy M13 (Midnight Blue, 6GB, 128GB Storage) | 6000mAh Battery | Upto 12GB RAM with RAM Plus",Samsung,4.1,"1,57,088",13999,17999,31998,22
"realme narzo 50i (Carbon Black, 4GB RAM+64GB Storage) - 6.5"" inch Large Display | 5000mAh Battery",realme,4,"19,708",8999,9999,18998,10
"Samsung Galaxy M33 5G (Deep Ocean Blue, 8GB, 128GB Storage) | 6000mAh Battery | Upto 16GB RAM with RAM Plus | Travel Adapter to be Purchased Separately",Samsung,4,"8,508",19499,25999,45498,25
"I KALL Z5 Smartphone (3GB, 16GB) | Android 10.0 | 5.5 Inch Display (Blue)",I Kall,5,2,4699,5999,10698,22
"Nokia C21 Plus Android Smartphone, Dual SIM, 3-Day Battery Life, 4GB RAM + 64GB Storage, 13MP Dual Camera with HDR | Dark Cyan",Nokia,4.2,3,11299,12999,24298,13
"Lava Z21 (2GB RAM, 32GB ROM)-Blue| Octa Core Processor| Stock Android 11| Powerful 3100 mAh Battery",Lava,3.4,229,5599,5999,11598,7
"Tecno Camon 19 Neo (Ice Mirror, 6GB RAM, 128GB Storage)|48MP Super Night Rear Camera|32MP Selfie Camera|Upto 11GB Expandable RAM|6.8"" FHD+LTPS Display|Helio G85 Processor",Tecno,3.3,5,14999,18499,33498,19
"Nokia 5.1 Plus (Black, 32 GB) (3 GB RAM)",Nokia,3.9,265,9999,15999,25998,38
"Redmi Note 10T 5G (Graphite Black, 4GB RAM, 64GB Storage) | Dual5G | 90Hz Adaptive Refresh Rate | MediaTek Dimensity 700 7nm Processor | 22.5W Charger Included",Redmi,4.2,"1,21,362",11999,16999,28998,29
"realme narzo 50A Prime (Flash Black, 4GB RAM+64GB Storage) FHD+ Display | 50MP AI Triple Camera (No Charger Variant)",realme,4.1,"1,658",11499,13499,24998,15
"Samsung Galaxy M32 5G (Slate Black, 8GB RAM, 128GB Storage) | Dimensity 720 Processor | 5000mAh Battery| Knox Security",Samsung,4.1,"29,553",20999,25990,46989,19
"OPPO A15s (Fancy White, 4GB RAM, 64GB Storage) with No Cost EMI/Additional Exchange Offers",OPPO,4.3,"5,989",9990,13990,23980,29
"I KALL Z4 Smartphone (5.5 Inch Display, 4GB, 32GB) (Android 8.1) (Grey)",I Kall,,,4999,6499,11498,23
"I KALL K401 Smartphone (6.26 HD+ Display, 4GB, 64GB) (4G Volte, Dual Sim) (Dark Blue)",I Kall,2,2,6999,9999,16998,30
"Samsung Galaxy M13 5G (Aqua Green, 6GB, 128GB Storage) | 5000mAh Battery | Upto 12GB RAM with RAM Plus",Samsung,4.1,"1,57,088",15999,19499,35498,18
"Samsung Galaxy M53 5G (Deep Ocean Blue, 8GB, 128GB Storage) | 108MP | sAmoled+ 120Hz | 16GB RAM with RAM Plus | Travel Adapter to be Purchased Separately",Samsung,3.8,"2,741",28499,34999,63498,19
"Samsung Galaxy M13 (Aqua Green, 6GB, 128GB Storage) | 6000mAh Battery | Upto 12GB RAM with RAM Plus",Samsung,4.1,"1,57,088",13999,17999,31998,22
"Samsung Galaxy M33 5G (Deep Ocean Blue, 8GB, 128GB Storage) | 6000mAh Battery | Upto 16GB RAM with RAM Plus | Travel Adapter to be Purchased Separately",Samsung,4,"8,508",19499,25999,45498,25
"Redmi Note 10S (Deep Sea Blue, 6GB RAM, 64GB Storage) -Super Amoled Display | 33W Charger Included",Redmi,4.2,"72,687",12999,16999,29998,24
"I KALL Z9 Smartphone (6 Inch, 3GB, 32GB) (Green)",I Kall,5,2,5499,6999,12498,21
"I KALL Z1 Smartphone (5.5 Inch, 4GB, 32GB, Dual Sim) (Blue)",I Kall,2.2,6,4999,6499,11498,23
"Tecno Pop 5 LTE(Turquoise Cyan 2G+32GB)| 6.52"" HD+Dot Notch | 5000mAh | 8MP Dual Camera | Front Flash| IPX2 Splash Resistant",Tecno,4.2,"3,705",6699,8999,15698,26
"Tecno Spark 9 (Infinity Black, 6GB RAM, 128GB Storage)| Upto 11GB Expandable RAM | 90Hz Refresh Rate | 6.6"" HD+Display | 13MP Dual Camera | 5000mAh Battery | Helio G37 Gaming Processor",Tecno,4.2,27,9999,13499,23498,26
"Redmi Note 11 (Space Black, 6GB RAM, 64GB Storage) | 90Hz FHD+ AMOLED Display | Qualcomm® Snapdragon™ 680-6nm | Alexa Built-in | 33W Charger Included | Get 2 Months of YouTube Premium Free!",Redmi,4.1,"29,838",13999,18999,32998,26
"(Renewed) Samsung Galaxy Z Flip3 5G (Phantom Black, 8GB RAM, 256GB Storage) with No Cost EMI/Additional Exchange Offers",(Renewed) Samsung,3.2,7,66998,89999,156997,25
"I KALL Z8 4G Smartphone (5.5 Inch, 3GB, 16GB) (4G Volte) (Cyan)",I Kall,2.2,7,4699,5999,10698,22
"MOTOROLA e32s (Slate Gray, 3GB RAM 32GB Storage)",MOTOROLA,,,9460,12299,21759,23
"Tecno Camon 19 Neo (Eco Black, 6GB RAM, 128GB Storage)|48MP Super Night Rear Camera|32MP Selfie Camera|Upto 11GB Expandable RAM|6.8"" FHD+LTPS Display|Helio G85 Processor",Tecno,3.3,5,14999,18499,33498,19
"Tecno Spark 8T (Atlantic Blue,7GB Expandable RAM, 64GB Storage)| 50MP AI Camera | 6.6""(16.764cm) FHD+Display | 5000mAh",Tecno Spark,4.1,"4,933",9499,12999,22498,27
"OnePlus Nord 2T 5G (Gray Shadow, 8GB RAM, 128GB Storage) - Extra INR 3000 Exchange on OP Devices",OnePlus,4.1,861,28999,,,
"Samsung Galaxy M33 5G (Mystique Green, 8GB, 128GB Storage) | 6000mAh Battery | Upto 16GB RAM with RAM Plus | Travel Adapter to be Purchased Separately",Samsung,4,"8,508",19499,25999,45498,25
"I KALL Z8 4G Smartphone (5.5 Inch, 3GB, 16GB) (4G Volte) (Grey)",I Kall,2.2,7,4699,5999,10698,22
"realme C11 (2021) (Cool Blue, 2GB RAM, 32GB Storage) with No Cost EMI/Additional Exchange Offers",realme C,4.1,"11,392",,,,
"I KALL Z8 4G Smartphone (5.5 Inch, 3GB, 16GB) (4G Volte) (Blue)",I Kall,2.2,7,4699,5999,10698,22
"I KALL Z1 Smartphone (5.5 Inch, 4GB, 32GB, Dual Sim) (Grey)",I Kall,2.2,6,4999,6499,11498,23
"I KALL K401 Smartphone (6.26 HD+ Display, 4GB, 64GB) (4G Volte, Dual Sim) (Green)",I Kall,2,2,6999,9999,16998,30
"Samsung Galaxy M13 (Midnight Blue, 4GB, 64GB Storage) | 6000mAh Battery | Upto 8GB RAM with RAM Plus",Samsung,4.1,"1,57,088",11999,14999,26998,20
"I KALL Z5 Smartphone (3GB, 16GB) | Android 10.0 | 5.5 Inch Display (Green)",I Kall,5,2,4699,5999,10698,22
"Samsung Galaxy M32 (Light Blue, 6GB RAM, 128GB | FHD+ sAMOLED 90Hz Display | 6000mAh Battery | 64MP Quad Camera",Samsung,4.1,"44,417",16999,18999,35998,11
Nokia 2.1 Blue-Silver,Nokia,3.6,"2,170",5999,,,
Redmi 10 Prime (Astral White 6GB RAM 128GB ROM |Helio G88 with extendable RAM Upto 2GB |FHD+ 90Hz Adaptive Sync Display),Redmi,4.1,"46,562",13490,16999,30489,21
"OnePlus Nord 2T 5G (Jade Fog, 8GB RAM, 128GB Storage) - Extra INR 3000 Exchange on OP Devices",OnePlus,4.1,861,28999,33999,62998,15
"Samsung Galaxy M13 (Stardust Brown, 6GB, 128GB Storage) | 6000mAh Battery | Upto 12GB RAM with RAM Plus",Samsung,4.1,"1,57,088",13999,17999,31998,22
"Google Pixel 2 (18:9 Display, 128 GB) Just Black",Google,4.1,163,14990,70000,84990,79
"Redmi 9 Activ (Metallic Purple, 4GB RAM, 64GB Storage)",Redmi,4.2,"1,69,715",9499,10999,20498,14
"Samsung Galaxy M21 2021 Edition (Arctic Blue, 4GB RAM, 64GB Storage) | FHD+ sAMOLED | 6 Months Free Screen Replacement for Prime (SM-M215GLBDINS)",Samsung,4.2,"2,23,112",12999,14499,27498,10
"I KALL K440 Smartphone (6.53HD+ Display, 4GB, 64GB) (Gray)",I Kall,5,3,7499,10999,18498,32
"I KALL K475 Smartphone (4GB, 64GB) (Gold)",I Kall,3.1,5,6999,9999,16998,30
itel A23 Pro_Open Version (5'' FWVGA Bright Display | 8GB+1GB Memory | Smart Face Unlock | 2400mAh Battery | 2MP Rear Camera | Selfie Camera)_Lake Blue,itel,3,328,4249,4999,9248,15
"Samsung Galaxy M33 5G (Mystique Green, 6GB, 128GB Storage) | 6000mAh Battery | Upto 12GB RAM with RAM Plus | Travel Adapter to be Purchased Separately",Samsung,4,"8,508",17999,24999,42998,28
"realme narzo 50A (Oxygen Green , 4GB RAM + 128 GB Storage) Helio G85 Processor | 6000 mAh Battery",realme,4.2,"33,514",12499,13999,26498,11
"Samsung Galaxy M13 5G (Aqua Green, 6GB, 128GB Storage) | 5000mAh Battery | Upto 12GB RAM with RAM Plus",Samsung,4.1,"1,57,088",15999,19499,35498,18
"realme narzo 50 5G (Hyper Blue, 6GB RAM+128GB Storage) Dimensity 810 5G Processor | 48MP Ultra HD Camera",realme,4.4,297,17999,19999,37998,10
"I KALL K425 Smartphone (4GB, 64GB) (Grey)",I Kall,5,2,7599,11999,19598,37
"Oppo A54 (Starry Blue, 6GB RAM, 128GB Storage) with No Cost EMI & Additional Exchange Offers",Oppo,4.2,"1,792",11990,17990,29980,33
"Lava Z3 Striped Blue (3GB RAM, 32GB Storage)",Lava,4,721,7499,8499,15998,12
"I KALL K401 Smartphone (6.26 HD+ Display, 4GB, 64GB) (4G Volte, Dual Sim) (Sky Blue)",I Kall,2,2,6999,9999,16998,30
"I KALL Z6 Smartphone (4GB, 64GB) (Dark Blue)",I Kall,2,3,7499,9999,17498,25
"Samsung Galaxy M13 5G (Midnight Blue, 4GB, 64GB Storage) | 5000mAh Battery",Samsung,4.1,"1,57,088",13999,16999,30998,18
"I KALL K460 Smartphone (5.5 Inch, 3GB, 16GB) (4G Volte, Android 10) (Blue)",I Kall,,,4699,5999,10698,22
"I KALL Z8 4G Smartphone (5.5 Inch, 3GB, 16GB) (4G Volte) (Cyan)",I Kall,2.2,7,4699,5999,10698,22
"iQOO vivo Z6 44W (Raven Black, 4GB RAM, 128GB Storage) | 44W FlashCharge + 5000mAh Battery | FHD+ AMOLED Display | in-Display Fingerprint",iQOO,4.1,"5,357",14499,19999,34498,28
"Tecno POVA 3 (Electric Blue, 4GB RAM, 64GB Storage)| 7000mAh Battery |33W Fast Charger | 6.9"" FHD+ Display | 90 Hz Refresh Rate | 50MP Triple Camera | Helio G88 Gaming Processor",Tecno,4,256,11799,14499,26298,19
"Redmi Note 9 Shadow Black, 4GB RAM, 64GB Storage",Redmi,4.3,"82,987",13799,14999,28798,8
"I KALL Z5 Smartphone (3GB, 16GB) | Android 10.0 | 5.5 Inch Display (Blue)",I Kall,5,2,4699,5999,10698,22
"iQOO Z6 5G (Chromatic Blue, 8GB RAM, 128GB Storage) | Snapdragon 695-6nm Processor | 120Hz FHD+ Display | 5000mAh Battery",iQOO,4,"11,382",17999,21990,39989,18
"Redmi Note 11T 5G (Stardust White, 6GB RAM, 128GB ROM)| Dimensity 810 5G | 33W Pro Fast Charging | Charger Included | Additional Exchange Offers|Get 2 Months of YouTube Premium Free!",Redmi,4.1,"16,295",15999,20999,36998,24
"Tecno POVA 3 (Electric Blue, 6GB RAM, 128GB Storage)| 7000mAh Battery |33W Fast Charger | 6.9"" FHD+ Display | 90 Hz Refresh Rate | 50MP Triple Camera | Helio G88 Gaming Processor",Tecno,4,256,13499,15999,29498,16
"I KALL K475 Smartphone (4GB, 64GB) (Sky Blue)",I Kall,3.1,5,6999,9999,16998,30
"I KALL Z8 4G Smartphone (5.5 Inch, 3GB, 16GB) (4G Volte) (Grey)",I Kall,2.2,7,4699,5999,10698,22
"Nokia C01 Plus 4G, 5.45” HD+ Screen, Selfie Camera with Front Flash (Blue)",Nokia,3.6,"1,660",6224,7999,14223,22
"I KALL Z8 Smartphone (5.5 Inch Display, 3GB, 16GB) | Android 10 | Cyan",I Kall,2.9,16,4699,5999,10698,22
"Samsung Galaxy M32 (Light Blue, 4GB RAM, 64GB | FHD+ sAMOLED 90Hz Display | 6000mAh Battery | 64MP Quad Camera",Samsung,4.1,"44,417",14999,16999,31998,12
"Samsung Galaxy M32 (Black, 6GB RAM, 128GB | FHD+ sAMOLED 90Hz Display | 6000mAh Battery | 64MP Quad Camera",Samsung,4.1,"44,417",16999,18999,35998,11
"SAMSUNG Galaxy F42 5G (Matte Aqua, 6GB RAM 128GB Storage)",SAMSUNG,3.9,101,15200,23999,39199,37
"Redmi 9 Activ (Coral Green, 6GB RAM, 128GB Storage)",Redmi,4.2,"1,69,715",10999,12499,23498,12
"(Renewed) Nokia C01 Plus 4G, 5.45” HD+ Screen, Selfie Camera with Front Flash | 32GB Storage (Grey)",(Renewed,3,2,5566,6790,12356,18
"iQOO Z6 5G (Dynamo Black, 6GB RAM, 128GB Storage) | Snapdragon 695-6nm Processor | 120Hz FHD+ Display | 5000mAh Battery",iQOO,4,"11,382",16999,20990,37989,19
"I KALL K440 Smartphone (6.53HD+ Display, 4GB, 64GB) (Cyan)",I Kall,5,3,7499,10999,18498,32
"I KALL Z9 Smartphone (6 Inch, 3GB, 32GB) (Blue)",I Kall,5,2,5499,6999,12498,21
"Samsung Galaxy M13 5G (Aqua Green, 4GB, 64GB Storage) | 5000mAh Battery | Upto 8GB RAM with RAM Plus",Samsung,4.1,"1,57,088",13999,16999,30998,18
"I KALL K475 Smartphone (4GB, 64GB) (Tarnish)",I Kall,3.1,5,6999,9999,16998,30
"POCO C31 (Royal Blue, 64 GB) (4 GB RAM)",POCO,3.4,40,,,,
"Redmi 9A Sport (Carbon Black, 3GB RAM, 32GB Storage) | 2GHz Octa-core Helio G25 Processor | 5000 mAh Battery",Redmi,4.2,"1,78,833",7799,9499,17298,18
"Samsung Galaxy S20 FE 5G (Cloud Navy, 8GB RAM, 128GB Storage) with No Cost EMI & Additional Exchange Offers",Samsung,4.4,"17,194",39990,74999,114989,47
Apple iPhone 13 (128GB) - Starlight,Apple,4.6,"7,569",68900,79900,148800,14
"iQOO vivo Z5 5G (Mystic Space, 8GB RAM, 128GB Storage) | Snapdragon 778G 5G Processor | 5000mAh Battery | 44W FlashCharge",iQOO,4.2,"19,780",19990,29990,49980,33
"iQOO Neo 6 5G (Dark Nova, 8GB RAM, 128GB Storage) | Snapdragon® 870 5G | 80W FlashCharge",iQOO,4.4,"5,937",29999,34999,64998,14
"Samsung Galaxy F42 5G (Matte Black, 128GB, 6GB RAM)",Samsung,3.7,83,14835,23999,38834,38
"Nokia G20 Smartphone, Dual SIM 4G, 4GB RAM/64GB Storage, 48MP Quad Camera with 6.5” (16.51 cm) Screen | Silver, 4GB+64Gb",Nokia,3.7,"2,994",12989,14999,27988,13
"I KALL Z6 Smartphone (4GB, 64GB) (Green)",I Kall,2,3,7499,9999,17498,25
"I KALL Z9 Smartphone (6 Inch, 3GB, 32GB) (Green)",I Kall,5,2,5499,6999,12498,21
"I KALL Z2 Smartphone (6 Inch, 3GB, 16GB) (Gross Green)",I Kall,3,2,4999,6499,11498,23
"Nokia G21 Android Smartphone, Dual SIM, 3-Day Battery Life, 6GB RAM + 128GB Storage, 50MP Triple AI Camera | Dusk",Nokia,4.1,832,14999,16999,31998,12
"Tecno Pop 5 LTE(Ice Blue 2G+32GB)| 6.52"" HD+Dot Notch | 5000mAh | 8MP Dual Camera | Front Flash| IPX2 Splash Resistant",Tecno,4.2,"3,705",6699,8999,15698,26
"realme narzo 50A (Oxygen Blue , 4GB RAM + 64 GB Storage) Helio G85 Processor | 6000 mAh Battery",realme,4.2,"33,514",11499,12999,24498,12
"Lava X2 (2+32GB, Striped Blue) | Fingerprint Sensor | Octa Core Mediatek Processor | 6.5"" HD+ Display | 8MP Dual AI Camera | 5000 mAh Battery | Type-C Charger",Lava,4.1,748,6999,7999,14998,13
"(Renewed) Nokia G21 Android Smartphone, Dual SIM, 3-Day Battery Life, 6GB RAM + 128GB Storage, 50MP Triple AI Camera | Nordic Blue",(Renewed,3,4,12749,14999,27748,15
"Samsung Galaxy M13 5G (Midnight Blue, 6GB, 128GB Storage) | 5000mAh Battery | Upto 12GB RAM with RAM Plus",Samsung,4.1,"1,57,088",15999,19499,35498,18
BB Z10 Compatible with BlackBerry with 8 MP Camera (Black),BB,,,6599,12999,19598,49
"I KALL Z2 Smartphone (6 Inch, 3GB, 16GB) (Dark Blue)",I Kall,3,2,4999,6499,11498,23
"Vivo Y73 (Roman Black, 8GB RAM, 128GB Storage) with No Cost EMI/Additional Exchange Offers",Vivo,4.3,"2,295",19990,24990,44980,20
"Samsung Galaxy M13 5G (Midnight Blue, 6GB, 128GB Storage) | 5000mAh Battery | Upto 12GB RAM with RAM Plus",Samsung,4.1,"1,57,088",15999,19499,35498,18
"I KALL Z2 Smartphone (6 Inch, 3GB, 16GB) (Gross Green)",I Kall,3,2,4999,6499,11498,23
"itel A48 (Gradation Green, 2GB RAM, 32GB Storage)",itel,3.8,802,6489,6999,13488,7
"Samsung Galaxy M13 (Stardust Brown, 4GB, 64GB Storage) | 6000mAh Battery | Upto 8GB RAM with RAM Plus",Samsung,4.1,"1,57,088",11999,14999,26998,20
"Jio Phone Next 32 GB ROM, 2 GB RAM, Blue Smartphone",Jio,4.3,2,4880,8590,13470,43
"POCO C31 (Shadow Gray, 64 GB) (4 GB RAM)",POCO,3.7,34,,,,
"iQOO vivo Z6 44W (Lumina Blue, 4GB RAM, 128GB Storage) | 44W FlashCharge + 5000mAh Battery | FHD+ AMOLED Display | in-Display Fingerprint",iQOO,4.1,"5,357",14499,19999,34498,28
"iQOO Z6 5G (Dynamo Black, 8GB RAM, 128GB Storage) | Snapdragon 695-6nm Processor | 120Hz FHD+ Display | 5000mAh Battery",iQOO,4,"11,382",17999,21990,39989,18
"Samsung Galaxy M52 5G (ICY Blue, 6GB RAM, 128GB Storage) Latest Snapdragon 778G 5G | sAMOLED 120Hz Display",Samsung,4.2,"15,376",24999,34999,59998,29
"Nokia 2.3 Android 10 Smartphone 2GB RAM, 32GB Storage, Dual Rear Camera, Cyan Green",Nokia,3.6,"1,166",6999,10499,17498,33
"I KALL Z6 Smartphone (4GB, 64GB) (Sky Blue)",I Kall,2,3,7499,9999,17498,25
"Vivo Y73 (Diamond Flare, 8GB RAM, 128GB Storage) with No Cost EMI/Additional Exchange Offers",Vivo,4.3,"2,295",19989,24990,44979,20
"OPPO A55 (Rainbow Blue, 4GB RAM, 64GB Storage) with No Cost EMI/Additional Exchange Offers",OPPO,4,550,14990,18990,33980,21
"Realme 9 5G (Meteor Black, 4GB RAM, 64GB Storage)",Realme,4,33,13859,18999,32858,27
BB Bold 9780 Compatible with BlackBerry with 5 MP Camera (Black),BB,,,6299,12999,19298,52
"Redmi Note 11 Pro + 5G (Mirage Blue, 6GB RAM, 128GB Storage) | 67W Turbo Charge | 120Hz Super AMOLED Display | Additional Exchange Offers | Charger Included| Get 2 Months of YouTube Premium Free!",Redmi,3.7,"12,190",20999,24999,45998,16
"Vivo Y01 (Sapphire Blue, 2GB RAM, 32GB ROM) with No Cost EMI/Additional Exchange Offers",Vivo,4.1,15,8499,12990,21489,35
"I KALL K401 Smartphone (6.26 HD+ Display, 4GB, 64GB) (4G Volte, Dual Sim) (Dark Blue)",I Kall,2,2,6999,9999,16998,30
"Vivo Y75 5G (Glowing Galaxy, 8GB RAM, 128GB ROM) with No Cost EMI/Additional Exchange Offers",Vivo,3.9,40,21990,25990,47980,15
"Nokia G20, 48MP Quad Camera, 5050 mAh Battery, 6.5"" HD+ Screen, 4 + 64GB Memory (Blue)",Nokia,3.7,"2,994",12989,14999,27988,13
"Samsung Galaxy M13 (Stardust Brown, 4GB, 64GB Storage) | 6000mAh Battery | Upto 8GB RAM with RAM Plus",Samsung,4.1,"1,57,088",11999,14999,26998,20
"I KALL K460 Smartphone (5.5 Inch, 3GB, 16GB) (4G Volte, Android 10) (Cyan)",I Kall,,,4699,5999,10698,22
"Xiaomi Redmi 10A (Sea Blue, 4GB RAM, 64GB Storage)",Xiaomi,3.9,938,8999,11999,20998,25
"Samsung Galaxy A73 5G Awesome Mint, 8GB RAM, 256GB Storage",Samsung,,,44999,49990,94989,10
"Samsung Galaxy M33 5G (Emerald Brown, 6GB, 128GB Storage) | 6000mAh Battery | Upto 12GB RAM with RAM Plus | Travel Adapter to be Purchased Separately",Samsung,4,"8,508",17999,24999,42998,28
"OnePlus Nord CE 2 5G (Gray Mirror, 6GB RAM, 128GB Storage)",OnePlus,4.3,"36,852",23999,,,
SHIVANSH Micromax Canvas Tabby P469 Family Tablet 1 GB RAM | 8 GB ROM | Expandable Upto 32 GB,SHIVANSH,,,3490,5990,9480,42
"MOTOROLA e32s (Misty Silver, 4GB RAM 64GB Storage)",MOTOROLA,4,2,10700,11999,22699,11
Redmi 10 Prime (Phantom Black 6GB RAM 128GB ROM |Helio G88 with extendable RAM Upto 2GB |FHD+ 90Hz Adaptive Sync Display),Redmi,4.1,"46,562",13499,16999,30498,21
"Samsung Galaxy M53 5G (Deep Ocean Blue, 6GB, 128GB Storage) | 108MP | sAmoled+ 120Hz | 12GB RAM with RAM Plus | Travel Adapter to be Purchased Separately",Samsung,3.8,"2,741",26499,32999,59498,20
"I KALL Z8 4G Smartphone (5.5 Inch, 3GB, 16GB) (4G Volte) (Blue)",I Kall,2.2,7,4699,5999,10698,22
"Micromax X809 (Blue, Anti Theft, 1000mAh)",Micromax,3.1,81,1365,1999,3364,32
"Redmi Note 11 Pro + 5G (Stealth Black, 6GB RAM, 128GB Storage) | 67W Turbo Charge | 120Hz Super AMOLED Display | Additional Exchange Offers | Charger Included| Get 2 Months of YouTube Premium Free!",Redmi,3.7,"12,190",20999,24999,45998,16
"(Renewed) Nokia C01 Plus 4G, 5.45” HD+ Screen, Selfie Camera with Front Flash | 32GB Storage (Blue)",(Renewed,3,2,5524,6299,11823,12
"OnePlus 10R 5G (Sierra Black, 8GB RAM, 128GB Storage, 80W SuperVOOC)",OnePlus,4.2,"2,430",34999,38999,73998,10
Nokia 105 Single SIM (Black),Nokia,,,,,,
"Redmi K50i 5G (Phantom Blue, 8GB RAM, 256GB Storage)| Flagship Mediatek Dimensity 8100 Processor | 144Hz Liquid FFS Display | Alexa Built-in",Redmi,,,28999,35999,64998,19
"Nokia C21 Plus Android Smartphone, Dual SIM, 3-Day Battery Life, 3GB RAM + 32GB Storage, 13MP Dual Camera with HDR | Dark Cyan",Nokia,,,10299,11999,22298,14
"Nokia C20 Plus, 6.5""(16.51cm) HD+ Screen, 4950 mAh Battery, 3 + 32GB Memory (Dark Grey)",Nokia,3.7,667,8999,10499,19498,14
"Jio Phone Next 32 GB ROM, 2 GB RAM, Black Smartphone",Jio,3.3,8,4748,7299,12047,35
"OnePlus Nord 2T 5G (Jade Fog, 12GB RAM, 256GB Storage) - Extra INR 3000 Exchange on OP Devices",OnePlus,4.1,861,33999,,,
"Redmi Note 10T 5G (Metallic Blue, 4GB RAM, 64GB Storage) | Dual 5G | 90Hz Adaptive Refresh Rate | MediaTek Dimensity 700 7nm Processor | 22.5W Charger Included",Redmi,4.2,"1,21,362",11999,16999,28998,29
"Micromax X512 Anniversary Edition 1750 mAh, Torch Blink on Call, Auto Call Recording Phone (Blue)",Micromax,3.6,"1,114",1112,1799,2911,38
"Samsung Galaxy M33 5G (Deep Ocean Blue, 6GB, 128GB Storage) | 6000mAh Battery | Upto 12GB RAM with RAM Plus | Travel Adapter to be Purchased Separately",Samsung,4,"8,508",17999,24999,42998,28
"Infinix Hot 11 2022 (Aurora Green, 4GB RAM 64GB Storage)",Infinix,,,9799,12999,22798,25
"Samsung Galaxy M13 5G (Aqua Green, 4GB, 64GB Storage) | 5000mAh Battery | Upto 8GB RAM with RAM Plus",Samsung,4.1,"1,57,088",13999,16999,30998,18
"(Renewed) Nokia C01 Plus 4G, Android 11 (Go Edition), 5.45” HD+ Screen, Dual SIM, 2GB RAM/16GB Storage | Blue",(Renewed) Nokia,3.3,53,5290,6224,11514,15
"Oppo A54 (Crystal Black, 6GB RAM, 128GB Storage) with No Cost EMI & Additional Exchange Offers",Oppo,4.2,"1,792",11990,17990,29980,33
"Redmi Note 10S (Cosmic Purple, 8GB RAM,128 GB Storage) - Super Amoled Display | 64 MP Quad Camera | Alexa Built in | 33W Charger Included",Redmi,4.2,"72,687",16499,20999,37498,21
"Tecno Spark 8T (Turquoise Cyan,7GB Expandable RAM, 64GB Storage)| 50MP AI Camera | 6.6"" FHD+Display | 5000mAh",Tecno,4.1,"4,933",9499,12999,22498,27
"Lava Z3 Pro (3GB RAM, 32GB Storage)- Cyan | High Performance Octa core Processor| Big 5000 mAh Battery | 8MP AI Dual Rear Camera",Lava,4,721,7499,8499,15998,12
"Redmi Note 11S (Polar White, 8GB RAM, 128GB Storage)|108MP AI Quad Camera | 90 Hz FHD+ AMOLED Display | 33W Charger Included | Additional Exchange Offers|Get 2 Months of YouTube Premium Free!",Redmi,4,"3,025",18499,21999,40498,16
"Samsung Galaxy M32 5G (Sky Blue, 6GB RAM, 128GB Storage) | Dimensity 720 Processor | 5000mAh Battery| Knox Security",Samsung,4.1,"29,553",18999,23990,42989,21
"I KALL K460 Smartphone (5.5 Inch, 3GB, 16GB) (4G Volte, Android 10) (Blue)",I Kall,,,4699,5999,10698,22
"I KALL K570 Smartphone (6.53 Inch HD+ Display, 4GB, 64GB) (4G Volte) (Sapphire)",I Kall,5,2,7999,10999,18998,27
Xiaomi 11 Lite NE 5G (Jazz Blue 6GB RAM 128 GB Storage) | Slimmest (6.81mm) & Lightest (158g) 5G Smartphone | 10-bit AMOLED with Dolby Vision | Additional Exchange Offers Available,Xiaomi,4,"18,929",24999,31999,56998,22
"I KALL K475 Smartphone (4GB, 64GB) (Sky Blue)",I Kall,3.1,5,6999,9999,16998,30
"Panasonic Eluga i7 (2GB RAM, 16GB Storage, Finger Print Sensor, 4000mAh Battery) (Black)",Panasonic,3.1,"7,258",7290,10999,18289,34
"(Renewed) Nokia G21 Android Smartphone, Dual SIM, 3-Day Battery Life, 4GB RAM + 64GB Storage, 50MP Triple AI Camera | Nordic Blue",(Renewed,3,4,11049,14499,25548,23
"Samsung Galaxy S20 FE 5G (Cloud Mint, 8GB RAM, 128GB Storage)",Samsung,4.4,"17,194",39990,74990,114980,47
"Motorola Moto e32s (4GB, 64GB)(Misty Silver)",Motorola,3,1,10625,12999,23624,18
"OnePlus Nord 2 5G (Blue Haze, 8GB RAM, 128GB Storage)",OnePlus,4.3,"88,884",29999,,,
"OnePlus 10R 5G (Forest Green, 12GB RAM, 256GB Storage, 80W SuperVOOC)",OnePlus,4.2,"2,430",38999,42999,81998,9
"(Renewed) Nokia 5.4 (Polar Night, 4GB RAM, 64GB Storage) with No Cost EMI/Additional Exchange Offers",(Renewed) Nokia,3.9,27,8999,16799,25798,46
"realme C11 2021 (Cool Grey, 4GB RAM, 64GB Storage), Medium (RMX3231)",realme,4.1,"11,392",,,,
Vivo Y15s Wave Green (3GB RAM & 32GB ROM) with No Cost EMI/Additional Exchange Offers,Vivo,4.1,159,9499,13990,23489,32
"Nokia G10, 6.5"" (16.51 cm) HD+ Screen, 5050 mAh Battery, Triple Camera, 4 + 64GB Memory (Dark Blue)",Nokia,3.8,178,11498,13999,25497,18
"Redmi Note 11 (Starburst White, 6GB RAM, 128GB Storage)|90Hz FHD+ AMOLED Display | Qualcomm® Snapdragon™ 680-6nm | Alexa Built-in | 33W Charger Included | Get 2 Months of YouTube Premium Free!",Redmi,4.1,"29,838",15999,19999,35998,20
"Redmi K50i 5G (Phantom Blue, 6GB RAM, 128GB Storage) | Flagship Mediatek Dimensity 8100 Processor | 144Hz Liquid FFS Display | Alexa Built-in",Redmi,,"Save ₹1,500",25999,31999,57998,19
"Nuveck GIONEE A1 Lite (Black, 32 GB)  (3 GB RAM)",Nuveck,,Only 2 left in stock.,6440,6839,13279,6
"Itel Magic 2(Black, 4G, Wi-Fi Hotspot Support)",Itel,3.9,"1,333",2899,3099,5998,6
"Xiaomi 11i 5G (Purple Mist, 8GB RAM, 128GB Storage)",Xiaomi,4.4,6,24990,31999,56989,22
"Nokia 1 (Warm Red, 1GB RAM, 8GB Storage)",Nokia,3.6,"5,347",4999,6499,11498,23
"(Renewed) Nokia C3 Sand, 2GB RAM, 16GB Storage",(Renewed,3.2,97,6979,8499,15478,17
"Nokia C30, 6000 mAh Battery, 6.82 Inch HD+ Screen, 3 + 32GB Memory (Green)",Nokia,3.4,185,9948,12499,22447,20
"realme narzo 50A Prime (Flash Blue, 4GB RAM+64GB Storage) FHD+ Display | 50MP AI Triple Camera (No Charger Variant)",realme,4.1,"1,658",11499,13499,24998,15
"Nokia C21 Plus Android Smartphone, Dual SIM, 3-Day Battery Life, 4GB RAM + 64GB Storage, 13MP Dual Camera with HDR | Warm Grey",Nokia,5,1,11299,12999,24298,13
"Nokia XR20 5G, IP68 & Military-Grade casing, Corning Gorilla Glass Victus, 6GB RAM/128GB Storage, Blue",Nokia,4.3,65,44999,52999,97998,15
"Tecno Spark 8C Turquoise Cyan (3GB+64GB) | Upto 6GB RAM |90Hz Refresh Rate |6.6"" HD+ Display | 5000mAh |13MP Dual Camera| IPX2 Splash Resistant",Tecno,4.2,"4,893",8799,10999,19798,20
"Nokia C21 Plus Android Smartphone, Dual SIM, 3-Day Battery Life, 3GB RAM + 32GB Storage, 13MP Dual Camera with HDR | Warm Grey",Nokia,,,10299,11999,22298,14
"Do Mobile Mate-1 Dual Sim, Volte, Android, 4G Smartphone - (Gold)",Do,2.6,8,5500,6500,12000,15
"OPPO A16e (White, 4GB RAM, 64GB Storage) with No Cost EMI/Additional Exchange Offers",OPPO,4.3,82,10490,15990,26480,34
"Redmi Note 10T 5G (Chromium White, 6GB RAM, 128GB Storage) | Dual5G | 90Hz Adaptive Refresh Rate | MediaTek Dimensity 700 7nm Processor | 22.5W Charger Included",Redmi,4.1,"1,174",13999,18999,32998,26
"Redmi Note 11 (Space Black, 6GB RAM, 128GB Storage)|90Hz FHD+ AMOLED Display | Qualcomm® Snapdragon™ 680-6nm | Alexa Built-in | 33W Charger Included | Get 2 Months of YouTube Premium Free!",Redmi,4.1,"29,838",15999,19999,35998,20
"Moto G71 5G (Arctic Blue, 128 GB) (6 GB RAM)",Moto,3.3,3,17499,22999,40498,24
"realme C11(2021) (Cool Grey, 2GB RAM, 32GB Storage) Without Offers",realme C,4.1,"11,392",7190,7999,15189,10
"Samsung Galaxy M13 5G (Stardust Brown, 6GB, 128GB Storage) | 5000mAh Battery | Upto 12GB RAM with RAM Plus",Samsung,4.1,"1,57,088",15999,19499,35498,18
"realme 9i (Prism Black, 128 GB)  (6 GB RAM)",realme,4.3,100,,,,
"MI Redmi Y1 (Grey, 3GB RAM, 32GB Storage)",MI,4.1,"10,870",8999,9999,18998,10
"OPPO A15s (Fancy White, 4GB, 128GB Storage) AI Triple Camera | 6.52"" HD+ Screen | 2.3GHz Mediatek Helio P35 Octa Core Processor",OPPO,4.3,"5,989",10990,14990,25980,27
"(Renewed) Samsung Galaxy M53 5G (Mystique Green, 6GB, 128GB Storage) | 108MP Camera | sAmoled+ 120Hz | 32MP Front Camera | 6nm Processor | 12GB RAM with RAM Plus | Travel Adapter to be Purchased Separately",(Renewed) Samsung,,,22999,26499,49498,13
"Nillkin Case for Xiaomi Poco M4 Pro 4G (6.43"" Inch) Super Frosted Hard Back Dotted Grip Cover PC White Color",Nillkin,,,1599,1999,3598,20
"iQOO Neo 6 5G (Cyber Rage, 8GB RAM, 128GB Storage) | Snapdragon® 870 5G | 80W FlashCharge",iQOO,4.4,"5,937",29999,34999,64998,14
"AppIe lPhone 5S (Space Grey, 16GB)",AppIe,,,13599,24999,38598,46
BB Bold 9700 Compatible with BlackBerry with 3 MP Camera (Black),BB,,Only 2 left in stock.,6299,12999,19298,52
"I KALL K401 Smartphone (6.26 HD+ Display, 4GB, 64GB) (4G Volte, Dual Sim) (Sky Blue)",I Kall,2,2,6999,9999,16998,30
NOKIA C30 TA-1345 DS 4/64 in WH (White),NOKIA,3.4,185,10998,13499,24497,19
"Redmi 9 Activ (Carbon Black, 6GB RAM, 128GB Storage)",Redmi,4.2,"1,69,715",10999,12999,23998,15
"iQOO vivo Z6 44W (Lumina Blue, 8GB RAM, 128GB Storage) | 44W FlashCharge + 5000mAh Battery | FHD+ AMOLED Display | in-Display Fingerprint",iQOO,4.1,"5,357",16999,20999,37998,19
"Redmi Note 11T 5G (Matte Black, 6GB RAM, 128GB ROM)| Dimensity 810 5G | 33W Pro Fast Charging | Charger Included | Additional Exchange Offers|Get 2 Months of YouTube Premium Free!",Redmi,4.1,"16,295",15999,20999,36998,24
"Redmi Poco C3 (Arctic Blue, 3 RAM / 32 Storage)",Redmi,4,691,7888,9999,17887,21
"OnePlus 10R 5G (Sierra Black, 12GB RAM, 256GB Storage, 80W SuperVOOC)",OnePlus,4.2,"2,430",38999,42999,81998,9
"I KALL K435 Smartphone (4GB, 64GB) (Green)",I Kall,3,2,7599,11999,19598,37
"iQOO Neo 6 5G (Dark Nova, 12GB RAM, 256GB Storage) | Snapdragon® 870 5G | 80W FlashCharge",iQOO,4.4,"5,937",33999,39999,73998,15
"Vivo Y73 (Diamond Flare, 8GB RAM, 128GB Storage) with No Cost EMI/Additional Exchange Offers",Vivo,4.3,"2,295",19989,24990,44979,20
"Redmi 10 Power (Sporty Orange, 8GB RAM, 128GB Storage)",Redmi,3.7,69,14999,18999,33998,21
"iQOO 9 SE 5G (Sunset Sierra, 8GB RAM, 128GB Storage) | Qualcomm Snapdragon 888 | 66W Flash Charge",iQOO,4.3,"5,223",33990,39990,73980,15
"OPPO F19 (Prism Black, 6GB RAM, 128GB Storage) 48MP Triple Camera | AMOLED FHD+ Display | 5000 mAh Battery",OPPO,4.1,"1,086",14990,20990,35980,29
"Realme C35 (Glowing Black, 6GB RAM, 128GB Storage)",Realme,,,,,,
Nokia 2.1 (Blue-Copper),Nokia,3.6,"2,170",5999,6999,12998,14
"(Renewed) Redmi 7 (Comet Blue, 3GB RAM, IPS LCD Display, 32GB Storage, 4000mAH Battery)",(Renewed,3.1,14,6999,9999,16998,30
"K460 Smartphone (5.5 Inch Display, 3GB, 16GB) | Android 10 | Cyan",K460,,,6000,,,
"Samsung Galaxy M52 5G (ICY Blue, 8GB RAM, 128GB Storage) Latest Snapdragon 778G 5G | sAMOLED 120Hz Display",Samsung,4.2,"15,376",26999,36999,63998,27
Apple iPhone 13 (128GB) - Midnight,Apple,4.6,"7,569",68900,79900,148800,14
"KECHAODA SM Company K33 Bluetooth Dialer with Camera and Dual Sim,Slim Card Size and Light Weight and Stylish Mobile Phone(Black)",KECHAODA,3.9,78,1299,1399,2698,7
"OnePlus 10R 5G (Sierra Black, 12GB RAM, 256GB Storage, 150W SuperVOOC)",OnePlus,4.2,"2,430",39999,43999,83998,9
"Alcatel 5V (Blue, 32 GB) (3 GB RAM)",Alcatel,4,28,6490,9990,16480,35
"GT Master Edition 5G (128GB, Cosmos Black 6 GB RAM, New)",GT,4.3,6,23399,26999,50398,13
"Motorola Edge 30 (Meteor Grey, 128 GB) (6 GB RAM)",Motorola,5,2,,,,
(Renewed) Tecno Phantom X Iceland Blue (8GB+256GB) |Ultra Flagship Curved Display |Flexible AMOLED Screen| 50MP Camera with 108MP Ultra HD Mode | 48MP+8MP Selfie | in-Display FP Sensor | Heat Pipe Cooling,(Renewed) Tecno,2.5,3,22099,25999,48098,15
"Redmi Note 11T 5G (Matte Black, 8GB RAM, 128GB ROM)| Dimensity 810 5G | 33W Pro Fast Charging | Charger Included | Additional Exchange Offers| Get 2 Months of YouTube Premium Free!",Redmi,4.1,"16,295",17999,22999,40998,22
"Nokia 4.2 (Black, 3GB RAM, 32GB Storage)",Nokia,4,"10,094",8999,14999,23998,40
"Samsung Galaxy A52s 5G (Mint, 8GB RAM, 128GB Storage) Without Offer",Samsung,3.9,33,27750,40999,68749,32
"(Renewed) Realme Narzo 30 (Racing Silver, 6GB RAM, 128GB Storage) Without Offers",(Renewed) Realme,4.3,7,13740,16999,30739,19
"Redmi Note 11T 5G (Aquamarine Blue, 6GB RAM, 128GB ROM)| Dimensity 810 5G | 33W Pro Fast Charging | Charger Included | Additional Exchange Offers| Get 2 Months of YouTube Premium Free!",Redmi,4.1,"16,295",15999,20999,36998,24
"(Renewed) Nokia C01 Plus 4G, Android 11 (Go Edition), 5.45” HD+ Screen, Dual SIM, 2GB RAM/16GB Storage | Grey",(Renewed) Nokia,3.3,53,5268,6225,11493,15
"Redmi Note 11T 5G (Aquamarine Blue, 8GB RAM, 128GB ROM)| Dimensity 810 5G | 33W Pro Fast Charging | Charger Included | Additional Exchange Offers| Get 2 Months of YouTube Premium Free!",Redmi,4.1,"16,295",17999,22999,40998,22
"MI REDMI 9i Sport (Coral Green, 64 GB) (4 GB RAM)",MI,4.3,30,,,,
"Infinix Hot 11 2022 (Sunset Gold, 4GB RAM 64GB Storage)",Infinix,,,9799,12999,22798,25
"I KALL K435 Smartphone (4GB, 64GB) (Sky Blue)",I Kall,3,2,7599,11999,19598,37
"Nokia 3.1 (Black, 32GB)",Nokia,3.8,354,7999,11999,19998,33
"Redmi 5 (Black, 3GB RAM, 32GB Storage)",Redmi,4.2,"15,669",7999,11999,19998,33
"POCO M4 Pro (Cool Blue, 6GB RAM 64GB Storage)",POCO,,,14999,17999,32998,17
"Samsung Galaxy A53 Orange, 6GB RAM, 128GB Storage",Samsung,1,1,34498,38990,73488,12
"Redmi 10 (Midnight Black, 4GB RAM, 64GB Storage)",Redmi,3.7,89,10690,14999,25689,29
"MOTOROLA e32s (Slate Gray, 4GB RAM 64GB Storage)",MOTOROLA,4,2,,,,
"realme narzo 50A Prime (Flash Black, 4GB RAM+128GB Storage) FHD+ Display | 50MP AI Triple Camera (No Charger Variant)",realme,4.1,"1,658",12449,14499,26948,14
"Micromax in 2B (Blue, 4GB RAM, 64GB Storage)",Micromax,3,90,8999,10499,19498,14
"OPPO A16e (Midnight Black, 3GB RAM, 32GB Storage) with No Cost EMI/Additional Exchange Offers",OPPO,4.3,82,9490,13990,23480,32
"Redmi Note 11S (Space Black, 8GB RAM, 128GB Storage)|108MP AI Quad Camera | 90 Hz FHD+ AMOLED Display | 33W Charger Included | Additional Exchange Offers| Get 2 Months of YouTube Premium Free!",Redmi,4,"3,025",18499,21999,40498,16
"Tecno Spark 7 (Morpheus Blue, 2GB RAM, 32 GB Storage) - 6000mAh Battery|16 MP Dual Camera| 6.52” Dot Notch Display| Octa Core Processor",Tecno,4,"5,740",8999,,,
"Samsung Galaxy M21 2021 Edition (Charcoal Black, 4GB RAM, 64GB Storage) | FHD+ sAMOLED | 6 Months Free Screen Replacement for Prime (SM-M215GZKDINS)",Samsung,4.2,"2,23,112",12999,14999,27998,13
"realme narzo 50A Prime (Flash Blue, 4GB RAM+128GB Storage) FHD+ Display | 50MP AI Triple Camera (Charger to be Bought Separately)",realme,4.1,"1,658",12449,14499,26948,14
"MOTOROLA e32s (Misty Silver, 3GB RAM 32GB Storage)",MOTOROLA,,,,,,
"realme narzo 50 (Speed Black, 4GB RAM+64GB Storage) Helio G96 Processor | 50MP AI Triple Camera | 120Hz Ultra Smooth Display",realme,4.3,"5,769",12999,15999,28998,19
"OPPO A16e (Blue, 3GB RAM, 32GB Storage) with No Cost EMI/Additional Exchange Offers",OPPO,4.3,82,9490,13990,23480,32
"Lava Z2s- (Striped Blue, 2GB RAM, 32 GB Storage) – 6.5” HD+ IPS Display | 5000 mAh Battery | Loud Audio, Regular (LE000Z93P_s)",Lava,4.1,136,6798,7999,14797,15
Lava Agni 5G |64 MP AI Quad Camera| (8GB RAM/128 GB ROM)| 5000 mAh Battery| Superfast 30W Fast Charging| 6.78 inch Big Screen (Fiery Blue),Lava,4.3,567,17990,23999,41989,25
"Vivo Y75 5G (Starlight Black, 8GB RAM, 128GB ROM) with No Cost EMI/Additional Exchange Offers",Vivo,3.9,40,21990,25990,47980,15
"(Renewed) realme narzo 50i (Mint Green, 2GB RAM+32GB Storage) - 6.5"" inch Large Display | 5000mAh Battery Without Offers",(Renewed) realme,3.2,12,7290,7999,15289,8
"vivo Y15C (Mystic Blue, 3GB RAM, 64GB Storage) with No Cost EMI/Additional Exchange Offers",vivo,3.3,86,10499,14990,25489,30
"Tecno POVA 3 (Tech Silver, 6GB RAM, 128GB Storage)| 7000mAh Battery |33W Fast Charger | 6.9"" FHD+ Display | 90 Hz Refresh Rate | 50MP Triple Camera | Helio G88 Gaming Processor",Tecno,4,256,13299,14999,28298,11
"Nokia 3.2 (Black, 3GB RAM, 32GB Storage)",Nokia,3.7,728,7999,11999,19998,33
"Redmi Note 11 Pro (Stealth Black, 6GB RAM, 128GB Storage) | 67W Turbo Charge | 120Hz Super AMOLED Display",Redmi,3.9,"1,860",18999,22999,41998,17
"(Renewed) Redmi Y3 (Elegant Blue, 32GB, 3GB RAM)",(Renewed,3.2,33,6799,13999,20798,51
Apple iPhone 13 (128GB) - Blue,Apple,4.6,"7,569",68900,79900,148800,14
"Samsung Galaxy M53 5G (Emerald Brown, 8GB, 128GB Storage) | 108MP | sAmoled+ 120Hz | 16GB RAM with RAM Plus | Travel Adapter to be Purchased Separately",Samsung,3.8,"2,741",28499,34999,63498,19
"Nuveck KARBONN K9 Smart Yuva 4G Volte (Black & Champagne, 8 GB)  (1 GB RAM)",Nuveck,,,3549,4599,8148,23
"(Renewed) iQOO Z6 5G (Dynamo Black, 4GB RAM, 128GB Storage)",(Renewed,2.5,4,13399,19990,33389,33
"realme narzo 50 (Speed Black, 6GB RAM+128GB Storage) Helio G96 Processor | 50MP AI Triple Camera | 120Hz Ultra Smooth Display",realme,4.3,"5,769",15499,17999,33498,14
"India Gadgets - V20 5G Rugged Android 11 Mobile Phone: 8Gb + 256Gb: 64MP + 20MP Night Vison Camera: 6.43"" AMOLED FHD+ Display: 6000mAh Battery 33W + 15W Fast Wireless Charging: Waterproof Smartphone",India,5,1,48500,56000,104500,13
"Redmi 2GB RAM, 16GB Storage Mi 6A, Black",Redmi,4.1,"1,02,573",,,,
"iQOO vivo Z6 Pro 5G (Phantom Dusk, 12GB RAM, 256GB Storage) | Snapdragon 778G 5G | 66W FlashCharge | 1300 nits Peak Brightness | HDR10+",iQOO,4.2,"3,291",28999,33990,62989,15
"realme narzo 30 5G (Racing Blue, 6GB RAM, 128GB Storage) with No Cost EMI/Additional Exchange Offers",realme,4.2,"2,186",16999,17999,34998,6
"Xiaomi 11i 5G (Purple Mist, 6GB RAM, 128GB Storage)",Xiaomi,3.7,22,22990,29999,52989,23
"(Renewed) Nokia 6.1 Plus TA-1083 DS (Blue, 64GB)",(Renewed,3.4,133,16999,18599,35598,8
"(Renewed) Nokia G21 Android Smartphone, Dual SIM, 3-Day Battery Life, 4GB RAM + 64GB Storage, 50MP Triple AI Camera | Dusk",(Renewed,3,4,12499,14499,26998,13
